NO ./textures/north_texture_xpm.xpm
SO ./textures/south_texture_xpm.xpm
WE ./textures/west_texture_xpm.xpm
EA ./textures/east_texture_xpm.xpm

F 0,128,255
C 135,65,0

        1111111111111111111111111
        1001000000010000000000001
111111111011000001111000000000001
100000000010000011101111111111111
1111N111111111011100000010001
11110111111111011101010010001
11000000110101011100000010001
10000000000000000000000010001
10000000000000001101010010011
11000001110101011111011110011
11110111111101011101111010001
111111    1111111111111111111